%%%%%%%%%%%%%%%%%%%%%
P     %             %
%%%%% % %%% %%%%%%% %
%     % %   %       %
% %%%%% %%%%%%%%%%%%%
%     %   %     %   %
%%%%% %%% %%%%% % % %
% %   %       %   % %
% % %%% %%%%% %%%%% %
%   %       %   %   %
% % % %%%%% %%% % % %
% % % %     %     % %
%%% %%% % %%%%%%%%% %
%   %   % %         %
% %%% %%% %%%%%%%%%%%
% %   % % %       % %
% % % % % % %%%%% % %
%   %   %   %   % % %
%%%%%%%%%%% % %%% % %
%           %       .
%%%%%%%%%%%%%%%%%%%%%
