%%%%%%%%%%%%%%%%%%%%%%%%%%
%P      % % %            %
% %%%%%%% % %%% % %%% %% %
%       %       % %      %
%%%%% %%%%% %%% % % % %%%%
%   % % % %   % % % %    %
% %%% % % % %%% %%%%%    %
%             %   %      %
%%% %%%%%%%%% %%%%%%%% % %
%%% %%%%%%%%%%%%%%%%%%%%%%
%       % % %            %
% %%%%%%% % %%% % %%% %% %
%               % %      %
%%%%% %%%%% %%% % % % %%%%
%   % % % %   % % % %    %
% %%% % % % %%% %%%%%    %
%       %     %   %     .%
%%%%%%%%%%%%%%%%%%%%%%%%%%
