%%%%%%%%%%%%%%%%%%%%%%%%%%%%%%%%%
%%                              %
%% %%%%%%%%%%%%%%%%%%%%%%%%%%%% %
%%                            % %
%% %%%%%%%%%%%%%%%%%%% %%%%%%%% %
%P                            % %
% %%%%%%%%%%%%%%%%%%%%%%%%%%%%% %
% %                           % %
% %%%%% %%% %%%%%%%%%% %%%%%%%% %
% %   % % % %    % % % %      % %
% %   % % % % %%%% % %%% %%%% % %
% %%%%% % %              %    % %
%     % % % %%%%%%%%%%%%%% %%%% %
% %%%%% % % %%%%%%%%%%%%%% %%%% %
% %   % % % %%%%%%%%%%%%%%%%%%% %
% %   % % %           .         %
% %%%%% %%%%%%%%%%%%%%%%%% %%%% %
%       %%%%%      %%%     %% % %
% %%%%% %%%%% %%%% %%% %%%%%% % %
% %%%%% %%%%% %%%% %%% %%%%%% % %
% %%%%% %%%%% %%%% %%% %%%%%% % %
%     %       %%%%     %%       %
%%%%%%%%%%%%%%%%%%%%%%%%%%%%%%%%%
