%%%%%%%%%%%%%%%%%%%%%%%%%
P         % %     %   % %
% %%%%%%% % % %%% % % % %
%   %   %   % %   % % % %
%%% % % %%% % % %%% % % %
%   % % %   % %   % %   %
% %%%%% % %%% %%% % %%%%%
% %   % %     % %   %   %
% % % % %%%%% % %%%%% %%%
%   % % %     %     %   %
% %%% % % %%%%%%%%% %%% %
%   %   % %     % %   % %
% % %%%%% % %%% % %%% % %
% % %   %   % % %       %
% % % % %%%%% % %%%%% %%%
% %   %       %         %
% %%%%%%%%%%%%%%%%%%% % %
%     %           %   % %
% %%%%% %%%%%%%%% % %%% %
%       %   %   % % %   %
%%% %%%%% % % %%% % % %%%
%   % %   % %   % %     %
% %%% % %%% % % % % %%% %
%       %   % %         .
%%%%%%%%%%%%%%%%%%%%%%%%%
