%%%%%%%%%%%%%%%%%%%%%
P %               % %
% % % % %%%%%%% % % %
% % % %       % % % %
% % % %%%%%%%%% % % %
% % % %       % %   %
% % % % %%%%% % %%%%%
% % % %     % % %   %
% %%% %%% % % % % % %
%     %   % % % % % %
%%% %%%%%%% % % %%% %
%     %     % %   % %
%%%%% % %%%%% %%% % %
%   %     %     % % %
% % %%%%% %%% % % % %
% %     % %   %   % %
% %%%%% % % %%% %%% %
% %   % % %   % %   %
% % % % %%%%% % % % %
%   % %       %   % .
%%%%%%%%%%%%%%%%%%%%%
